1111111111111
1P00000000001
100C000000001
100000E000001
1000001000001
100001C100001
1111111111111
