1111111111111111111111111111111111111111111111
1C0E000000000000000000000000000000000000000001
1C10000000000000000000000000000000000000000001
1C10000000000000000000000000000000000000000001
1C10000000000000000000000000000000000000000001
1C10000000000000000000000000000000000000000001
1C10000000000000000000000000000000000000000001
1C10000000000000000000000000000000000000000001
1C10000000000000000000000000000000000000000001
1C10000000000000000000000000000000000000000001
1C10000000000000000000000000000000000000000001
1C10000000000000000000000000000000000000000001
1C10000000000000000000000000000000000000000001
1C10000000000000000000000000000000000000000001
1C10000000000000000000000000000000000000000001
1C10000000000000000000000000000000000000000001
1C10000000000000000000000000000000000000000001
1C10000000000000000000000000000000000000000001
1C10000000000000000000000000000000000000000001
1C10000000000000000000000000000000000000000001
1C10000000000000000000000000000000000000000001
1C10000000000000000000000000000000000000000001
1C10000000000000000000000000000000000000000001
1C10000000000000000000000000000000000000000001
1C10000000000000000000000000000000000000000001
1C10000000000000000000000000000000000000000001
1C10000000000000000000000000000000000000000001
1C10000000000000000000000000000000000000000001
1CP0000000000000000000000000000000000000000001
1111111111111111111111111111111111111111111111
