1111111111111
10000000C0P01
0000011111111
100000E000001
1111111111111