1111111111111
1CCCCCCCCCCC1
1CCCCCCCCCCC1

1CCCCCPCCCCC1
1CCCCCCCCCCC1
1CCCCCECCCCC1
1111111111111