11111
1PCE1
11111
1C001
11111
