11111
1P001
1C001
100E1
11111
