111111111
110000011
1E00P00C1
110000011
111111111
10000C001
10C0C0C01
100C00001
111111111