111111111111111111
1C0000000000000001
1C1000000000000001
1C1000000000000001
1C1E000000000000P1
111111111111111111